8
8
........
........
...~~...
.C.~~...
...~~...
........
........
........


